NO assets/argentina-team.png
SO assets/PABLEADO.png
WE assets/daniego2.png
EA assets/danielos.png

F 120,219,104
C 79,201,207



1111111111111111111
1000000000000000001
100010000S000010001
10000000000000000001
1000000000000000001
1000000000000000001
1000100000000000001
1000000000000000001
1111111111111111111